1111111111111111111
100000000E000000001
1000000000000000001
1001111111111111001
1001000000000001001
11111X1X1X1X1X1X001
1P00C0C0C0C0C0C0001
1000000100010001001
1111111111111111111