111111111111111111111111111111
1C010000100000CC10001C000000C1
10C1000C010000CC10C01110001111
1C010000C01000011010000X001001
10C100000C01000X10000000011CC1
1C01000000C0100000000000111CC1
10C10000000C01E000000001111CC1
1C0100000000C010000000000X0001
10C1000000000C0100000000000001
1C0100000000000000000000000001
100100010000000001000100011111
1001111111000000011111110X01C1
10P000000000000000000C010001C1
1000X000000000000X00CCC10001C1
100010CX0C0C0C0C00000C01000001
111111111111111111111111111111