111111111111111111111111111111
100000C0000000CCC00000000000E1
10000C0000000C000C00000000X001
1000C00C0000C000C000000X000001
1000CCCCCC00000C00000000011001
1000000C000000C000000001110001
1000000C00000CCCCCCC000110CC01
10011111111111111111111110CC01
10000000000000000C111111100001
100000000000X00000X11111111111
111111110C01110000000000000001
100000010011C11000000000000001
100101011110001111111110000111
1000X0X0CC0000X0C0X0C000001111
1P010C00CC00000000000000011111
111111111111111111111111111111