111111111111111111111111111111
1P1E000000000000000001C00000C1
1011110X00X011100000001C0X0C11
100001111111100000000001C1C001
1000111000000000000000001C0111
1001111000000X0000000001C1C001
11000000000000000000001C0X0C11
1111111111111100000000C00000C1
111111100000000000000000000001
111111100000000000001111111111
100X0X0000000000000000X0X0X001
1C00000000000000000000000000C1
111111111111110001111111111111
111111111111000C00011111111111
10CCCCCCCCCCCCCCCCCCCCCCCCCC01
111111111111111111111111111111