11111111111111111
10CCCCCCC11000001
1000CCC000101E001
10000C00000011111
10000000000000001
1P000010C01000001
11111110001111111
10C00000000000C01
1CCC000000X00CCC1
10C00000000000C01
11111111111111111