111111111111111111111111111111
10P000000000000000000000000001
100000000000000000000000000001
1000000C00000000000000000C0001
10000000C000000000000000C00001
100000000C0000000000000C000001
1000000000C00000000000C0000001
10000000000C000000000C00000001
100000000000C0000000C000000001
1000000000000C00000C0000000001
10000000000000C000C00000000001
100000000000000C0C000000000001
1000000000000000C0000000000001
100000000000000100000000000001
100000000000001E10000000000001
111111111111111111111111111111