111111111111111111111111111111
1000000000000000C0C0C0111001E1
100000000000001111111110001101
100100000000001000000000111001
100100000000001000000000000001
100110001C1C1C1C1C100000000001
100011000101010101000000000001
100C01100010101010000011100001
10CCC0100000000000001111000001
100C001000000000000001110C0C01
10000110000000000000001100C001
1111110000000000000000110C0C01
100000000000000000000011111111
10P0000000000000000000011100C1
100000011111000000000000000011
111111111111111111111111111111