111111111111111111
1000000000000000011
10000P00000000000001
100000000000C0000001
100000E000000000001
111111111111111111