1111111111111111111111111
1111011111111100000000001
11100100000001000000000E1
1100110111110100000000001
110111110000010C000000001
11010111011111010000C0001
110000010000010C000CCC001
11110111111111010000C0001
11110111P000000C000000001
1111111111111111111111111